22
8
......................
......................
......................
..P......E.....EE.....
...............HH.....
................H.....
.........H......H.....
######################
