22
8
......................
......................
......................
..P..............E....
.................#....
.................#....
.................#....
######################
